%%%%%%%%%%%%%%%%%%%%%%%%
%.                    .%
%                      %
%                      %
%                      %
%.    P               .%
%%%%%%%%%%%%%%%%%%%%%%%%
