%%%%%%%%%%%%%%%%%%%%%%%%%%%%%%%%%%%%%
%.                                  %
%                                   %
%                                   %
%                                   %
%                                   %
%                                   %
%                                   %
%                                   %
%                                   %
%                                   %
%                                   %
%                                   %
%                                   %
%                                   %
%                                   %
%                                   %
%                                   %
%                                   %
%                                   %
%                                   %
%                                   %
%                                   %
%                                   %
%                                   %
%                                   %
%                                   %
%                                   %
%                                   %
%                                   %
%                                   %
%                                   %
%                                   %
%                                   %
%                                   %
%                                   %
%                                   %
%                                  P%
%%%%%%%%%%%%%%%%%%%%%%%%%%%%%%%%%%%%%
