%%%%%%%%%%%%%%%%%%%%%%%%%%%%%%%%%%%%%
%                                   %
%                                   %
%                                   %
%                                   %
%                                   %
%                                   %
%                                   %
%                                   %
%                                   %
%                                   %
%                                   %
%                                   %
%                                   %
%                                   %
%                                   %
%                                   %
%                                   %
%                                   %
%                                   %
%                                   %
%                                   %
%                                   %
%                                   %
%                                   %
%                                   %
%                                   %
%                                   %
%                                   %
%                                   %
%                                   %
%                                   %
%                                   %
%                                   %
%                                   %
%                                   %
%                                   %
%.                                 P%
%%%%%%%%%%%%%%%%%%%%%%%%%%%%%%%%%%%%%
