%%%%%%%%%%%%%%%%%%%%%%%%
%.         G          .%
%          %           %
%   %%%%%%%%           %
%          %           %
%.    P    %          .%
%%%%%%%%%%%%%%%%%%%%%%%%
