%%%%%
%. P%
% %.%
%G  %
%%%%%
