%%%%%%%%
%     .%
%   P  %
%      %
%G     %
%      %
%.    .%
%%%%%%%%
