%%%%%
%. P%
% %.%
% G %
%%%%%
