%%%%%%%%%
%. P    %
% %.%   %
%G      %
%%%%%%%%%
