%%%%%%%%%%%%%%%%%%%%%%%%
%.                     %
%          %           %
%   %%%%%%%%           %
%          %           %
%.    P    %.          %
%%%%%%%%%%%%%%%%%%%%%%%%
