%%%%%%%%%%%%%%%%%%%%%%%%
%                P  ...%
%  %     %%%%%% % %%%..%
%  %     %    % %   %..%
%  %     %    % %   %..%
%               % G %..%
%  %     %    % %   %..%
%  %     %    % %   %..%
%               %   %..%
%%%%%%%%%%%%%%%%%%%%%%%%
