%%%%%%%%
%G    .%
%   P  %
% %%%% %
% %    %
% % %%%%
%.%  O.%
%%%%%%%%
