%%%%%%%%%%%%%%%%%%
%                %
%                %
%         %      %
%         %      %
%         %      %
%    .    %      %
%         %      %
%         %      %
%         %     P%
%%%%%%%%%%%%%%%%%%
