%%%%%%%%%%%%%%%%%%
%      G      ...%
%.%   %%%% %.%%%.%
%.%   %  % %...%.%
%.%   %  % %...%.%
%.     P    ... .%
%%%%%%%%%%%%%%%%%%
